%%%%%%%%%
%*******%
%%%%*%%*%
%***P  *%
%*%%*%%*%
%*%**  *%
%%%%%%%%%
