%%%%%%%%%%%%%%%%%%%%%%
% %%        % %      %
%    %%%%%% % %%%%%% %
%%%%%%.....P  %      %
%....%.%%%%%% %% %%%%%
%.%%%%.%.....    %   %
%........%%%.%%%   % %
%%%%%%%%%%... %%%%%% %
%..........%%        %
%%%%%%%%%%%%%%%%%%%%%%
