%%%%%%%%%%%%%%%%%%%%%%%%%%%%%%%%%%%%%
%       % % %.........  %   %     % %
% %%%%%%% % %%%.% %%%.%%% %%%%%%% % %
%       %.......% %.....%     % %   %
%%%%% %%%%%.%%% % %.%.%%% %%%%% % %%%
%   % % %.%.  % % %.%...%.%   % %   %
% %%% % %.%.%%% %%%%%.%%%.% %%% %%% %
%       %.....%   %...%.....% % %...%
%%% %%%%%%%%%.%%%%%%%.%%%.%%% % %.%.%
%.............%.......%.%...%.....%.%
%.%.%%%%% % %%%.%.%.%%%.%.%%%.%%% %.%
%.%.%     % %.%.%.%.....%...%.%.% %.%
%.%.% %%%%%%%.%.%%%%%%%%%.%%%.%.%%%.%
%.%.% %.....%...%.....%.....%...%...%
%%%.%%%.%.%%%%%.%%%%%.%%%.%%%.%%%%%.%
%...  %.%.%.....%.%.....%.%...%.%.%.%
%.%.% %.%.%%%.%%%.%%%.%%%.%.%.%.%.%.%
%.%.% %.%.................%.%.%.....%
%%%.%%%%%%%.%.%.%%%%%.%%%.%.%%%.%%%%%
%.....  % %.%.%.....%...%.....%.%...%
%%%%%.% % %%%%%%%%%.%%%%%%%%%%%.%.%%%
%   %.%           %.%.....%...%.%...%
% %%%.%%%%% %%%%%%%%%.%%%%%.%.%.%%%.%
% %...%      %........%.....%.......%
% %.% %%%%% %%%.%.%.%.%.%%%%%%%%%%%%%
% %.%   %     %.%.%.%.......%...%.%.%
% %.%%% %%% % %.%.%%%%%%%%%.%%%.%.%.%
% %...% %   % %.%...%.%...%.%.%.....%
% %%%.%%% %%%%%.%%%.%.%.%%%%%.%.%%%%%
%.....  %   %.....%.%.....%...%.%...%
%%%.% %%%%% %%%%%.%%%.%%%.%.%%%.%.%%%
% %.% % % % %.%.....%.%...%.%...%.%.%
% %.%%% % % %.%.%%%%%%%%%.%.%.%.%.%.%
%...%   %   %.................%.....%
%.% % % %%% %%%.%%%%%%%.%%%.%%%.%%%.%
%.% % %       %...%.......%...%.%..P%
%%%%%%%%%%%%%%%%%%%%%%%%%%%%%%%%%%%%%
