%%%%%%%%%%%%%%%%%%%%
%***************P**%
%*%%*%%*%%*%%*%% %*%
% %% %*****      %*%
%%%%%%%%%%%%%%%%%%%%
