%%%%%%%%%%%%%%%%%%%%%%%%%%%%%%%%%%%%%
%..................................P%
%............%.                     %
%............%.                     %
%............%.                     %
%............%.                     %
%............%.                     %
%............%.     %               %
%............%.     %               %
%............%.     %               %
%............%.     %               %
%............%.     %               %
%............%.     %               %
%............%.     %               %
%%%%%%%%%%%%%%.     %%%%%%%%%%%%%%%%%
%            %.                     %
%            %.                     %
%            %.                     %
%..............                     %
%.                                  %
%.                                  %
%.                                  %
%%%%%%%%%%%%%%%%%%%%%%%%%%%%%%%%%%%%%
