%%%%%%%%%%%%%%%%%%%%%%%%%%%%%%%%%%%%
%.................................P%
%.%%%%%%%%%%%%%%%%%%%%%%% %%%%%%%% %
%.%%...%...%..    %%%%%%%   %%     %
%.%%.%.%.%.%.%%%% %%%%%%%%% %% %%%%%
%.%%.%.%.%.%....         %% %%     %
%.%%.%.%.%.%.%.%%%%  %%%    %%%%%% %
%.%..%.%.%...%....%% %%%%%%%%      %
%.%%.%.%.%%%%%%%%.%%        %% %%%%%
%.%%.%...%%.......%%%%%%%%% %%     %
%....%%%%%%.%%%%%%%      %% %%%%%% %
%%%%%%......%.......%%%% %% %      %
%......%%%%%%.%%%%%.%    %% %% %%%%%
%.%%%%%%......%.....  %%%%% %%     %
%........%%%%%%.%%%%%%%%%%% %%  %% %
%%%%%%%%%%......            %%%%%% %
%..........%%%%%%%%%%%%%%%%        %
%%%%%%%%%%%%%%%%%%%%%%%%%%%%%%%%%%%%
