%%%%%%%%%%%%%%%%%%%%%%%%%%%%%%%%%%%%%
%.......%.%.%...........%...%.....%.%
%.%%%%%%%.%.%%%.%.%%%.%%%.%%%%%%%.%.%
%.......%.......%.%.....%.....%.%...%
%%%%%.%%%%%.%%%.%.%.%.%%%.%%%%%.%.%%%
%...%.%.%.%...%.%.%.%...%.%...%.%...%
%.%%%.%.%.%.%%%.%%%%%.%%%.%.%%%.%%%.%
%.......%.....%...%...%.....%.%.%...%
%%%.%%%%%%%%%.%%%%%%%.%%%.%%%.%.%.%.%
%.............%.......%.%...%.....%.%
%.%.%%%%%.%.%%%.%.%.%%%.%.%%%.%%%.%.%
%.%.%.....%.%.%.%.%.....%...%.%.%.%.%
%.%.%.%%%%%%%.%.%%%%%%%%%.%%%.%.%%%.%
%.%.%.%.....%...%.....%.....%...%...%
%%%.%%%.%.%%%%%.%%%%%.%%%.%%%.%%%%%.%
%.....%.%.%.....%.%.....%.%...%.%.%.%
%.%.%.%.%.%%%.%%%.%%%.%%%.%.%.%.%.%.%
%.%.%.%.%.................%.%.%.....%
%%%.%%%%%%%.%.%.%%%%%.%%%.%.%%%.%%%%%
%.......%.%.%.%.....%...%.....%.%...%
%%%%%.%.%.%%%%%%%%%.%%%%%%%%%%%.%.%%%
%   %.%...........%.%.....%...%.%...%
% %%%.%%%%%.%%%%%%%%%.%%%%%.%.%.%%%.%
%.%...%......%........%.....%.......%
%.%.%.%%%%%.%%%.%.%.%.%.%%%%%%%%%%%%%
%.%.%...%.....%.%.%.%.......%...%.%.%
%.%.%%%.%%%.%.%.%.%%%%%%%%%.%%%.%.%.%
%.%...%.%...%.%.%...%.%...%.%.%.....%
%.%%%.%%%.%%%%%.%%%.%.%.%%%%%.%.%%%%%
%.......%...%.....%.%.....%...%.%...%
%%%.%.%%%%%.%%%%%.%%%.%%%.%.%%%.%.%%%
%.%.%.% % %.%.%.....%.%...%.%...%.%.%
%.%.%%% % %.%.%.%%%%%%%%%.%.%.%.%.%.%
%...%   %  .%.................%.....%
%.%.% % %%% %%%.%%%%%%%.%%%.%%%.%%%.%
%.%.% %       %...%.......%...%.%...%
%%%%%%%%%%%%%%%%%%%%%%%%%%%%%%%%%%%%%
