%%%%%%%%%%%%%%%%%%%%
%***************P**%
%*%%*%%*%%*%%*%%*%*%
% %%*%***********%*%
%%%%%%%%%%%%%%%%%%%%
