%%%%%%%%%
%*******%
%%%%*%%*%
%***P***%
%*%%*%%*%
%*%*****%
%%%%%%%%%
