%%%%%%%%%%%%%%%%%%%%
%**************%***%
%*%%*%%*%%*%%*%%*%*%
%********P*******%*%
%%%%%%%%%%%%%%%%%%*%
%******************%
%%%%%%%%%%%%%%%%%%%%
