%%%%%%%%%%%%%%%%%%%%%%
%.%%........%.%  ....%
%....%%%%%%.%.%%%%%%.%
%%%%%%........%......%
%....%.%%%%%%.%%.%%%%%
%.%%%%.%.........%...%
%........%%%.%%%...%.%
%%%%%%%%%%....%%%%%%.%
%..........%%........%
%%%%%%%%%%%%%%%%%%%%%%
