%%%%%%%%%%%%%%%%%%%%%%%%%%%%%%%%%%%%%
%       % % %  .......  %   %     % %
% %%%%%%% % %%%.% %%%.%%% %%%%%%% % %
%       %  .....% %  .  %     % %   %
%%%%% %%%%%.%%% % % %.%%% %%%%% % %%%
%   % % % %.  % % % %.  % %   % %   %
% %%% % % %.%%% %%%%%.%%% % %%% %%% %
%       %  ...%   %  .%     % % %...%
%%% %%%%%%%%%.%%%%%%%.%%% %%% % %.%.%
%  ...........%.......% %   %.....%.%
% %.%%%%% % %%%.% % %%% % %%%.%%% %.%
% %.%     % % %.% %     %   %.% % %.%
% %.% %%%%%%% %.%%%%%%%%% %%%.% %%%.%
% %.% %     %  .%     %     %.  %  .%
%%%.%%% % %%%%%.%%%%% %%% %%%.%%%%%.%
%  .  % % %  ...% %     % %...% % %.%
% %.% % % %%%.%%% %%% %%% %.% % % %.%
% %.% % %    .............%.% %.....%
%%%.%%%%%%% % % %%%%% %%%.%.%%%.%%%%%
%  ...  % % % %     %   %...  %.%   %
%%%%%.% % %%%%%%%%% %%%%%%%%%%%.% %%%
%   %.%           % %     %...%.%   %
% %%%.%%%%% %%%%%%%%% %%%%%.%.%.%%% %
% %...%      % .......%.....%...    %
% %.% %%%%% %%%.% % %.%.%%%%%%%%%%%%%
% %.%   %     %.% % %...    %   % % %
% %.%%% %%% % %.% %%%%%%%%% %%% % % %
% %...% %   % %.%   % %   % % %     %
% %%%.%%% %%%%%.%%% % % %%%%% % %%%%%
%  ...  %   %  ...% %     %   % %   %
%%%.% %%%%% %%%%%.%%% %%% % %%% % %%%
% %.% % % % % %...  % %   % %...% % %
% %.%%% % % % %.%%%%%%%%% % %.%.% % %
%...%   %   %  ...............%.....%
%.% % % %%% %%% %%%%%%% %%% %%% %%%.%
%.% % %       %   %       %   % %  .%
%%%%%%%%%%%%%%%%%%%%%%%%%%%%%%%%%%%%%