%%%%%%%%%%%%%%%%%%%%%%%%%%%%%%%%%%%%
%..................................%
%.%%%%%%%%%%%%%%%%%%%%%%%.%%%%%%%%.%
%.%%...%...%......%%%%%%%...%%.....%
%.%%.%.%.%.%.%%%%.%%%%%%%%%.%%.%%%%%
%.%%.%.%.%.%. ...........%%.%%.....%
%.%%.%.%.%.%.%.%%%%..%%%....%%%%%%.%
%.% .%.%.%...%....%%.%%%%%%%% .....%
%.%%.%.%.%%%%%%%%.%%........%%.%%%%%
%.%%.%...%%.......%%%%%%%%%.%%.....%
%....%%%%%%.%%%%%%%......%%.%%%%%%.%
%%%%%%......%.......%%%%.%%.% .....%
%......%%%%%%.%%%%%.%....%%.%%.%%%%%
%.%%%%%%......%.......%%%%%.%%.....%
%........%%%%%%.%%%%%%%%%%%.%%..%%.%
%%%%%%%%%%..................%%%%%%.%
%..........%%%%%%%%%%%%%%%%........%
%%%%%%%%%%%%%%%%%%%%%%%%%%%%%%%%%%%%
