%%%%%%%%%%%%%%%%%%%%%%%%%%%%%%%%%%%%%
%       % % %  .........%...%.....%.%
% %%%%%%% % %%%.%.%%%.%%%.%%%%%%%.%.%
%       %  .....%.%  .  %.....%.%...%
%%%%% %%%%%.%%%.%.% %.%%%.%%%%%.%.%%%
%   % % % %.  %.%.% %.  %.%...%.%...%
% %%% % % %.%%%.%%%%%.%%%.%.%%%.%%%.%
%       %  ...%...%  .%.....% %.%...%
%%% %%%%%%%%%.%%%%%%%.%%%.%%% %.%.%.%
%  ...........%.......%.%...%.....%.%
% %.%%%%%.%.%%%.%.%.%%%.%.%%%.%%%.%.%
% %.%.....%.% %.%.%.....%...%.% %.%.%
% %.%.%%%%%%% %.%%%%%%%%%.%%%.% %%%.%
% %.%.%     %  .%.....%.....%.  %  .%
%%%.%%% % %%%%%.%%%%%.%%%.%%%.%%%%%.%
%  .  % % %  ...%.%.....%.%...%.%.%.%
% %.% % % %%%.%%%.%%%.%%%.%.%.%.%.%.%
% %.% % %    .............%.%.%.....%
%%%.%%%%%%% %.%.%%%%%.%%%.%.%%%.%%%%%
%  ...  % % %.%.....%...%.....%.%   %
%%%%%.% % %%%%%%%%%.%%%%%%%%%%%.% %%%
%   %.%           %.%     %...%.%   %
% %%%.%%%%% %%%%%%%%% %%%%%.%.%.%%% %
% %...%      % .......%.....%...    %
% %.%.%%%%% %%%.%.%.%.%.%%%%%%%%%%%%%
% %.%...%     %.%.%.%...    %...%.%.%
% %.%%%.%%% % %.%.%%%%%%%%% %%%.%.%.%
% %...%.%   % %.%...%.%...% %.%.....%
% %%%.%%% %%%%%.%%%.%.%.%%%%%.%.%%%%%
%  .....%   %  ...%.%.....%...%.%...%
%%%.%.%%%%% %%%%%.%%%.%%%.%.%%%.%.%%%
% %.%.% % % % %...  %.%...%.%...%.%.%
% %.%%% % % % %.%%%%%%%%%.%.%.%.%.%.%
%...%   %   %  ...............%.....%
%.%.% % %%% %%%.%%%%%%%.%%%.%%%.%%%.%
%.%.% %       %...%.......%...%.%  .%
%%%%%%%%%%%%%%%%%%%%%%%%%%%%%%%%%%%%%
