%%%%%%%%%%%%%%%%%%%%%%%%%%%%%%%%%%%%%
%...................................%
%............%......................%
%............%......................%
%............%......................%
%............%......................%
%............%......................%
%............%......%...............%
%............%......%...............%
%............%......%...............%
%............%......%...............%
%............%......%...............%
%............%......%...............%
%............%......%...............%
%%%%%%%%%%%%%%......%%%%%%%%%%%%%%%%%
%............%......................%
%............%......................%
%............%......................%
%...................................%
%...................................%
%...................................%
%...................................%
%%%%%%%%%%%%%%%%%%%%%%%%%%%%%%%%%%%%%
