%%%%%%%%%%%%%%%%%%%%%%
%.%%........% %      %
%....%%%%%%.% %%%%%% %
%%%%%%........%      %
%....%.%%%%%%.%% %%%%%
%.%%%%.%.........%...%
%........%%%.%%%...%.%
%%%%%%%%%%....%%%%%%.%
%..........%%........%
%%%%%%%%%%%%%%%%%%%%%%
