%%%%%%%%%%%%%%%%%%%%
%.           ..%...%
%.%%.%%.%%.%%.%%.%.%
%................%.%
%%%%%%%%%%%%%%%%%%.%
%..................%
%%%%%%%%%%%%%%%%%%%%
